+--+--+g-+--+
#           |
+  +--+  +  g
|  |     |  |
#  +  +g-+--+
|  |        #
+  +--+--+  +
|        | g|
#--#--+--+--+