++++++++++
+        +
+  +-+   +
+  | |   +
+  +-+   +
+        +
+   #    +
+        +
++++++++++