+++++++++++
+         +
+ +-+ +-+ +
+ | | | | +
+ +-+ +-+ +
+         +
+   ###   +
+         +
+++++++++++